Ist jede Erfindung wirklich ein Fortschritt?
Jede Erfindung ist nicht unbedingt ein Fortschritt für die Menschheit, weil, zum Beispiel, die Atom Spaltung hat die Atombombe gegeben und die hat zweihundertsechzigtausend Personen getötet in Japan. Jede Erfindung kann von seinen Ziel, umgelenkt werden.
Eine andere nützliche Erfindung, ist das Dynamit. Nitroglycerin war instabil, um ungewollte Explosionen zu verhindern, hat Nobel den Dynamit erfunden. Das hat sicher unnötige Verlust von Menschenleben vermeiden. Aber, Die Dynamit ist auch schlecht für die Umwelt. Zum Beispiel, Dynamitfischerei, das zerstört die Umgebung und viele andere Lebewesen 
sterben auch.
Schließlich, die Zyklon-B ist ein Insektizid. Doch, im zweiten Weltkrieg hat Hitler es für seine "Endlösung der Judenfrage" verwendet. Das ist nicht wirklich eine gute Benutzung für eine Erfindung.



der Bauer = Fermier 
die Landwirte = les agriculteurs
Zu entfernen = a retirer
Der Fels = le rocher
War auch = a aussi été
Umlenken = détourné 
Bergwerke = la mine
eine Kutsche = une calèche
als Geisel nehmen = prendre en otage
ein Boot = un bateau
ein gutes Werkzeug = un bon outil 
ein Werkzeug = outil
für = pour
Navigieren = naviguer
Der Handel = le commerce
Von = à 
die Piraterie = la piraterie
ein Düngern = un fertilisant
sie als = s'en servent pour
das Vietnam auslöschen = anéantire le Vietnam
ein Pestizid = Pesticides
ein Insektizid = un instecticide
zur Verteidigung = condamner
ausrotten = exterminer
daher = résultant de
unbedingt = nécessairement
Menschheit = l'espèce humaine
Mensch = une personne
Verhinden = empêcher quelqu'un, quelque chose


Dynamit wurde auch von Dieben verwendet, um
Um Kutschen als Geiseln zu nehmen
