Levi Strauß:
Übung A):
Levi Strauß
Herkunft:
Levi Strauß war von Bayern und war Jude.
Auswanderung:
Er geht nach Kalifornien (in die USA) 
Arbeit:
Levi Strauß war Ein Straßenhändler nachher hat er ein Tuchhandel und dann steigt er in die Hosengeschäft ein. Er bekam ein erfolgreichen Unternehmer mit Levi Strauss & Company.
Tod:
Er starb im Jahre 1902 in Amerika.

Übung B):

Levi Strauß war einen erfolgreichen Auswanderer. Er beginnt als Straßenhändler, nach und nach eröffnet er einen Tuchhandel. Er will vom Goldrausch im Westen Amerikas profitieren. Eines Tages, ein Kunde, fragt ihm, ob er eine Hose aus Zeltstoff machen könnte, weil seine Hose zu schnell zerschleißt wird. Das war eine erfolgreiche Idee und Strauß erkennt die Möglichkeit. Er importiert ein neues Material von Nîmes, eine indigoblauen Stoff, die später Denim genannt wird. Strauß starb 1902 und hinterlässt die Levi Strauss & Company und 10.000 Mitarbeiter beschäftigt.

Stil = le style
Damals = avant
Noch = jusqu'à présent
Aufbrechen = partir en voyage
Auswanderung = émigration
Freiwillig = volontairement
Bayern = la Bavoire
Leiden = souffrir
Ärmsten = le plus pauvres
Armen = Les pauvres
Der Weg = le chemin
Wandern = airer
Staatsbürger = le citoyen
Sichern = sûre
Kunde = le client
Ob = si
Zelt = tante
Beine = les jambes
Anstrengend = fatigant
Zerschleißen = user de
Erkennen = reconnaitre/voir/se rendre compte
Schneider = un tailleur
Beinkleidern = leg clothes
Verbreiten = s'étendre
Bald = bientôt
Stoff = tissu
Erfolgreich = avoir du succès
Unternehmer = entrepreneur
Erben = l'héritage/hériter
Straßenhändler = un vendeur de rue.
Die Herkunft = l'origine
Schildern = décrire
Des Erfolgs = le succès
Ausgemachen = le succès
Stück für Stück = petit à petit
Einen Laden = une boutique
Aus Stoff von Zelt = du tissus de tante
