Henry Letellier T1	Deutsch	Sonntag, 29. November 2020
1)
Die Textsorte ist ein Interview mit Stephan Krawczyk, er ist ein Sänger von der DDR und ist ausgereist, weil er arbeitsverbot bekam. Er hat gegen die Regierung demonstriert und wurde verhaftet. Er hat ausgewählt in die BRD zu gehen anstatt im Gefängnis zu blieben. also immigriert er nach west Deutschland.

2)
Bevor die Berliner Mauer fällt, Krawczyk war ein DDR Musiker. Er ist von der SED Partei ausgetreten und seine Texte werden immer mehr regimekritischer und bekam Berufsverbot. Als er demonstrierte gegen dieses Verbot, wurde er verhaftet. Er wird vor die Wahl gestellt, entweder aus der DDR zu fliehen oder zehn Jahre im Gefängnis zu sitzen. Er hat gewählt in die BRD auszureisen. Es gibt mehrere Gründe: seine Frau wurde auch verhaftet und konnte es nicht aushalten. Noch dazu dachte er dass er nicht gegen die Regierung kämpfen konnte im Gefängnis. Das Titelblatt des Spiegels zeigt Krawczyk zeigt ein Musiker der durch seine Musik eine Rebellion hinter der Mauer unternommen hat, und ist bekannt geworden, also hat er eigentlich erfolgreich, weil er ist auf der Titelblatt.
Wie Krawczyk im Westen angekommen ist war es für ihm eine riesige Umstellung. Seine Angst war dass er von der Stasi noch verfolgt wurde. Es hat lang gebracht bis seine Seele im Westen anzukommen ist.

Ensuite, expliquez la situation de Krwackkk avant et après la chute du mur de Berlin : son expatriation, ses raisons et ses conséquences. Veuillez regarder la page de titre du miroir.

Mittel = moyen
Bestimmen = determiner
Wende = retournement de situation
Der Spiegel = le mirroire
Das Stern = étoile (Journal très connu comme der Spiegel)
Austräten = quitter
SED = Sozialistische Einheitspartei Deutschlands
Bedeutendsten = le plus important
Bedeuten = signifier
Gefängnis = la prison
Haften = arrêter
Teilnehmen = participer
Dürfen = avoir l’autorisation de
Auftreten = se produir
Ecke = l’angle
Schon = déjà
Leugnen = nier
Rücksitz = siège arrière
Ausreisen = partir
Kämpfen = se battre
Veränderungen = changement
Wahl = le choix
Wahlen = voter
Anwalt = l’avocat
Raten = conseiller
Herausstellen =révéler
Bewegen = convaincre/inciter
Haft = l’emprisonnement
Unwirklich = irréel
Wirklichkeit = la réalité
Wagten = tenter
2

