Die U-Bahn = le métro
Die S-bahn = le RER
Der Bus = le bus
Die Straßenbahn = le tramway
Verpassen = raten
Schnell ? langsam
Der Zug = le train
Voc pour le DST:
Der Freund ? der Feind 
Der Feind = l'énnemi
Die Grenze = la frontière/la limite
Der Zoll = la douane
Der Rentner (-) = le retraité
Die Rentnerin (-) = la retraitée
Besitzen = posséder
Die Haltung = le comportement
Die Ausnahme (n) = exception
Die Botschaft = le message/L'ambassade
Verbreiten = répandre, propager
Die Hausfrauen = la femme au foyer
Die 3K= Küche, Kinder, Kirche
Der Vorurteil (e) = préjugé
Sich behaupten = S'affirmer
Die Bewegung = le Mouvement (politique)
Die Rolle (n) = le Role
Der Wiederaufbau = la reconstruction
Der Lohn = le salaire 
Etwa = environ
Etwas = quelquchose
Obwohl = quoi que
Trösten = Consoler
Der Erfolg = le succès
Erfoldreich sein = être couronné de succès.
Dumm/Doof = idiot
Klug = intelligent
Abenteuer = l'aventure
Klingeln = Sonner
Die Art = sorte
Klingen = réosnner
Der Erfinder = inventeur
Gucken = regarder
Die Männer sind im Krieg gefallen und die Frauen mussten den Fabriken arbeiten.
Nach dem krieg haben die Frauen zu dem Wiederaufbau beigetragen.
Abschaffen
Waffen herzustellen produzieren.
Die Babypause = la pause paternelle
Die Frauen verdienen etwa ein viertel weniger als die Männer und bei gleicher Arbeit. Obwohl sie die gleiche Ausbildung haben.
Ursula von Leyen.
    - Ministerin
    - 7 Kinder
    - Seit 2009 ist sie Präsidentin der europäischen kommission.

Christine Lagarde
    - Der Internale Währungsfonds (FMI)
