Stil=le style
Damals=avant
Noch=jusqu'à présent
Aufbrechen=prendre la route
Ausreisen=partir en voyage
Auswanderung=émigration
Freiwillig=volontairement
Bayern=la Bavoire
Leiden=souffrir
Ärmsten=le plus pauvres
Armen=Les pauvres
Der Weg=le chemin
Wandern=airer
Staatsbürger=le citoyen
Sichern=sûre
Kunde=le client
Ob=si
Zelt=tante
Beine=les jambes
Anstrengend=fatigant
Zerschleißen=user de
Erkennen=reconnaitre/voir/se rendre compte
Schneider=un tailleur
Beinkleidern=leg clothes
Verbreiten=s'étendre
Bald=bientôt
Stoff=tissu
Erfolgreich=avoir du succès
Unternehmer=entrepreneur
Erben=l'héritage/hériter
Straßenhändler=un vendeur de rue.
Die Herkunft=l'origine
Schildern=décrire
Des Erfolgs=le succès
Ausgemachen=le succès
Stück für Stück=petit à petit
Einen Laden=une boutique
du tissus de tante*Statt/finden=avoir lieu
Die Wiedervereinigung=la fête nationnale
das Verhalten=le comportement
Bezeichnen=qualifier
Der Staat (en)=l'état
Behandeln=traiter.
Neben =à côté de
Sich interessieren für +A=s'interesser à
Aus/brechen=éclater
Die öffentliche Verbrennung=autodaffe
Die Voraussetzung=la condition
Der Büger (-)=le citoyen
Der Einwohner (-)=l'habitant
Die Stiftung=la fondation
Forschen=faire de la recherche
Leicht=facile/léger
Schwer=difficile/lourd