Das Gap Jahr:
1)
Ein "Gap-Jahr" ist ein Jahr, wo man ins Ausland geht. Man entdeckt neue Kulturen und Kunst. Und man hat neue Erfahrungen. "Das Gap Jahr ist eine Pause, bevor der Ernst Lebens richtig losgeht." "Das Gap Jahr kommt aus dem Englischen und heißt soviel wie "Eine Auszeit aus dem Alltag". (Z: 1-2), "eine Pause" (Z: 2), "Junge Menschen verbringen einige Monate im Ausland, um neue Eindrücke und Erfahrungen zu sammeln." (Z: 4-6). 

2)

Ein Gap-Jahr ermöglicht viele verschiedene Sachen: "das Erlernen bzw. die Verbesserung einer Fremdsprache." (Z:16-18), "Ein Auslandsjahr verschafft einen Überblick und erleichtert die Zukunftsplanung." (Z.26-27) 


Ermöglichen = rendre possible
Der Ausdruck = l'expression
Sich Ausdrucken = s'exprimer
Alltag = tout les jours
Soviel = à peu près 
die Möglichkeit = la possibilité
Ermöglichen = rendre possible
Wichtig = important
Sondern = au lieu de
Ausdrücken = imprimmer quelquechose
Zwecken = le but
Hauptsächlich = spécialement
Soviel wie = en gros
Nutzen = utiliser
Dienen = gagner (de l'argent)
Eine Pause = une pause
Entwicklung = le dévelloppement
Der Ernst = seriousness
Aufenthalt = rester
Weit = mondiale
Bekommen = recevoir
Verbietet = répendre
Einlicke = les idées
Bedeutung = les moyens
Vor allem = au dessus de tout
Immer = toujours
Immer mehr = encore plus
Außerdem = aussi
Einige = un peu
Eine Sprache = une langue
Eindsülce + Erfalnug = impressions + expériences
Teilnehmen = participer
Landschaft = le paysage
Kennen lernen = être connu
Verdienen = gagner de l'argent
Erleichtern = éclaircir, aider
Entdecken = déouvrir
